tid	gid	cond1	cond2	total_counts	cond1_counts	cond2_counts	dpi
3	1	0.07	0.25	32	7	25	-0.18
1	1	0.25	0.03	28	25	3	0.22
12	1	0.02	0.25	27	2	25	-0.23
8	1	0.15	0.11	26	15	11	0.04
7	1	0.2	0.02	22	20	2	0.18
5	1	0.1	0.05	15	10	5	0.05
6	1	0.05	0.1	15	5	10	-0.05
11	1	0.11	0.03	14	11	3	0.08
4	1	0.02	0.06	8	2	6	-0.04
13	1	0	0.08	8	0	8	-0.08
all_other	1	0.03	0.02	5	3	2	0.01